gender,race/ethnicity,parental level of education,lunch,test preparation course,math score,aptitude score,writing score,Total,GradePoints
male,group E,some college,standard,0,100,91,84,275,0.9
male,group C,some college,free/reduced,10,38,31,36,105,0.4
male,group E,high school,standard,10,83,74,73,230,0.8
female,group B,some college,standard,0,73,79,79,231,0.8
female,group A,some high school,free/reduced,10,74,80,81,235,0.8
male,group B,some high school,free/reduced,10,65,59,62,186,0.6
female,group D,some high school,standard,0,55,55,57,167,0.6
male,group A,high school,standard,10,85,87,89,261,0.9
male,group C,master's degree,standard,0,83,80,76,239,0.8
male,group A,associate's degree,free/reduced,0,38,29,32,99,0.3
female,group B,bachelor's degree,standard,0,54,70,68,192,0.6
male,group E,some college,standard,0,75,67,66,208,0.7
female,group B,high school,free/reduced,10,42,55,59,156,0.5
male,group B,associate's degree,standard,10,85,75,84,244,0.8
female,group C,associate's degree,standard,0,63,72,75,210,0.7
female,group D,some high school,free/reduced,10,73,68,77,218,0.7
male,group D,some high school,free/reduced,0,72,59,60,191,0.6
female,group A,some high school,standard,0,59,71,69,199,0.7
male,group E,some college,free/reduced,0,63,56,54,173,0.6
male,group D,master's degree,standard,0,67,59,61,187,0.6
female,group B,associate's degree,standard,0,56,54,60,170,0.6
female,group B,some high school,standard,0,83,81,80,244,0.8
female,group C,high school,standard,0,57,64,63,184,0.6
male,group B,some high school,standard,10,94,95,89,278,0.9
female,group D,some high school,standard,0,67,68,73,208,0.7
male,group D,some college,standard,0,93,85,84,262,0.9
male,group A,some college,standard,10,80,74,69,223,0.7
female,group E,bachelor's degree,standard,0,91,93,93,277,0.9
male,group A,some high school,standard,0,63,54,55,172,0.6
female,group C,master's degree,standard,0,65,66,69,200,0.7
male,group C,some high school,free/reduced,0,32,30,23,85,0.3
male,group C,high school,standard,1,86,91,90,267,0.9
female,group C,some college,standard,0,51,57,57,165,0.6
male,group A,high school,standard,1,72,64,64,200,0.7
female,group C,associate's degree,standard,0,89,96,86,271,0.9
male,group D,some college,standard,0,81,77,70,228,0.8
male,group B,high school,standard,0,86,78,72,236,0.8
female,group C,master's degree,free/reduced,0,60,82,81,223,0.7
female,group B,master's degree,standard,1,75,87,89,251,0.8
female,group D,some college,free/reduced,0,61,65,65,191,0.6
female,group E,some high school,free/reduced,0,33,53,48,134,0.4
male,group A,high school,free/reduced,0,60,65,59,184,0.6
female,group C,associate's degree,standard,0,77,80,76,233,0.8
female,group B,some high school,free/reduced,0,69,70,71,210,0.7
female,group E,high school,standard,1,73,81,78,232,0.8
female,group E,some college,standard,1,78,94,89,261,0.9
female,group C,some high school,standard,0,82,85,85,252,0.8
male,group E,associate's degree,free/reduced,0,80,69,67,216,0.7
female,group E,high school,standard,10,80,87,87,254,0.8
female,group E,bachelor's degree,free/reduced,10,53,68,74,195,0.7
male,group B,some college,free/reduced,10,92,81,86,259,0.9
male,group B,some college,free/reduced,0,43,50,42,135,0.5
male,group B,high school,standard,10,85,78,78,241,0.8
male,group D,some college,standard,0,79,71,71,221,0.7
female,group C,some high school,free/reduced,0,58,74,72,204,0.7
male,group A,some high school,standard,10,55,49,46,150,0.5
female,group E,high school,standard,0,57,65,62,184,0.6
male,group B,master's degree,standard,0,77,80,70,227,0.8
female,group D,some college,free/reduced,0,55,69,70,194,0.6
male,group D,bachelor's degree,standard,10,66,73,76,215,0.7
male,group C,high school,standard,0,50,35,31,116,0.4
male,group D,high school,standard,0,59,59,57,175,0.6
female,group E,some college,free/reduced,0,57,71,68,196,0.7
female,group C,associate's degree,standard,0,55,71,67,193,0.6
female,group A,high school,free/reduced,10,39,61,57,157,0.5
male,group E,associate's degree,standard,0,82,68,74,224,0.7
female,group C,high school,standard,0,40,39,43,122,0.4
male,group C,some college,standard,0,58,49,53,160,0.5
male,group D,high school,standard,0,79,73,78,230,0.8
female,group C,bachelor's degree,standard,10,69,75,78,222,0.7
female,group C,some college,standard,0,54,65,62,181,0.6
female,group A,some high school,standard,0,62,71,66,199,0.7
female,group D,master's degree,free/reduced,0,84,84,86,254,0.8
male,group C,some college,standard,0,52,53,54,159,0.5
female,group E,associate's degree,standard,0,83,77,79,239,0.8
female,group D,some high school,free/reduced,0,59,75,72,206,0.7
male,group E,master's degree,free/reduced,0,96,93,91,280,0.9
male,group A,some college,standard,10,55,58,61,174,0.6
female,group B,associate's degree,free/reduced,0,63,67,67,197,0.7
male,group D,some high school,standard,10,71,77,71,219,0.7
male,group C,some college,standard,0,69,59,55,183,0.6
female,group C,some high school,free/reduced,10,64,77,73,214,0.7
male,group B,master's degree,standard,0,76,76,70,222,0.7
male,group B,some high school,standard,0,61,57,52,170,0.6
male,group D,some college,free/reduced,0,60,57,57,174,0.6
female,group E,bachelor's degree,standard,0,98,100,100,298,1.0
male,group B,some high school,free/reduced,0,59,59,51,169,0.6
male,group C,some college,standard,0,77,82,74,233,0.8
female,group C,associate's degree,standard,10,96,100,98,294,1.0
male,group C,high school,free/reduced,10,88,89,83,260,0.9
female,group D,high school,free/reduced,0,46,58,57,161,0.5
male,group C,bachelor's degree,free/reduced,10,68,75,75,218,0.7
female,group E,associate's degree,standard,0,92,100,100,292,1.0
female,group D,associate's degree,free/reduced,10,84,98,100,282,0.9
female,group D,some high school,standard,0,35,38,33,106,0.4
male,group E,associate's degree,standard,0,95,90,86,271,0.9
female,group D,master's degree,standard,0,82,90,89,261,0.9
female,group E,master's degree,free/reduced,10,74,88,91,253,0.8
male,group D,some high school,standard,0,70,65,63,198,0.7
female,group D,high school,free/reduced,0,51,62,63,176,0.6
female,group E,high school,standard,0,49,66,65,180,0.6
female,group D,some college,standard,0,69,71,78,218,0.7
female,group B,some high school,free/reduced,10,68,81,77,226,0.8
male,group C,associate's degree,standard,0,96,86,89,271,0.9
female,group D,associate's degree,free/reduced,10,70,88,90,248,0.8
female,group A,some college,standard,10,71,86,93,250,0.8
female,group D,some high school,standard,0,60,69,69,198,0.7
female,group C,associate's degree,free/reduced,10,41,65,66,172,0.6
male,group C,high school,free/reduced,0,47,45,42,134,0.4
female,group E,high school,free/reduced,0,65,76,69,210,0.7
male,group D,high school,standard,10,98,79,79,256,0.9
male,group C,associate's degree,standard,10,83,84,80,247,0.8
male,group D,some college,free/reduced,0,73,71,75,219,0.7
male,group A,some high school,standard,0,52,49,41,142,0.5
male,group D,some high school,standard,10,72,72,77,221,0.7
female,group D,high school,standard,0,30,35,40,105,0.4
female,group E,high school,free/reduced,0,45,60,54,159,0.5
male,group C,bachelor's degree,standard,0,50,38,32,120,0.4
female,group D,high school,standard,10,70,70,74,214,0.7
male,group A,high school,standard,0,60,49,44,153,0.5
male,group D,associate's degree,standard,0,97,81,84,262,0.9
male,group C,master's degree,standard,0,86,86,86,258,0.9
female,group E,associate's degree,standard,0,70,74,76,220,0.7
female,group D,bachelor's degree,standard,0,52,56,57,165,0.6
male,group B,associate's degree,standard,0,71,59,59,189,0.6
male,group B,some college,standard,10,73,59,68,200,0.7
male,group C,some high school,standard,0,83,80,67,230,0.8
male,group C,some high school,free/reduced,10,76,83,79,238,0.8
male,group C,some high school,free/reduced,10,43,43,46,132,0.4
female,group B,some college,standard,0,73,65,67,205,0.7
male,group C,high school,free/reduced,0,61,61,61,183,0.6
male,group C,associate's degree,free/reduced,0,44,39,39,122,0.4
female,group C,associate's degree,free/reduced,0,82,89,85,256,0.9
female,group C,associate's degree,free/reduced,0,57,80,73,210,0.7
female,group E,some college,standard,0,52,44,48,144,0.5
male,group D,high school,standard,0,67,60,62,189,0.6
male,group D,high school,free/reduced,0,52,58,57,167,0.6
male,group B,associate's degree,free/reduced,0,47,43,45,135,0.5
female,group C,associate's degree,standard,0,60,56,59,175,0.6
male,group C,high school,free/reduced,0,49,51,39,139,0.5
female,group C,high school,standard,0,60,60,60,180,0.6
male,group A,high school,standard,0,70,57,58,185,0.6
male,group E,high school,standard,10,83,77,73,233,0.8
female,group C,bachelor's degree,standard,0,50,59,59,168,0.6
male,group D,associate's degree,free/reduced,10,71,70,67,208,0.7
female,group B,some high school,standard,10,53,59,64,176,0.6
male,group C,some college,standard,10,83,84,85,252,0.8
female,group D,associate's degree,standard,0,86,82,86,254,0.8
male,group A,some high school,standard,0,54,52,47,153,0.5
male,group C,bachelor's degree,standard,0,66,54,52,172,0.6
male,group D,some college,standard,0,76,73,69,218,0.7
female,group B,some college,standard,0,78,87,83,248,0.8
female,group C,high school,standard,0,86,82,84,252,0.8
female,group B,high school,free/reduced,10,29,50,42,121,0.4
female,group B,associate's degree,standard,0,41,57,59,157,0.5
male,group E,some college,standard,10,100,91,93,284,0.9
female,group B,some college,free/reduced,0,37,60,56,153,0.5
female,group A,associate's degree,standard,10,79,76,81,236,0.8
male,group B,some college,standard,10,79,68,70,217,0.7
female,group D,some high school,standard,0,57,66,63,186,0.6
female,group D,high school,standard,0,58,59,57,174,0.6
male,group D,master's degree,free/reduced,0,67,57,59,183,0.6
female,group C,some high school,free/reduced,0,50,67,61,178,0.6
male,group E,some college,standard,10,100,94,91,285,1.0
male,group A,associate's degree,free/reduced,0,55,46,43,144,0.5
male,group B,some high school,standard,10,57,52,51,160,0.5
male,group C,associate's degree,standard,10,72,76,74,222,0.7
male,group A,some college,free/reduced,0,52,54,46,152,0.5
male,group C,some high school,standard,0,63,76,66,205,0.7
male,group B,master's degree,free/reduced,0,78,73,76,227,0.8
male,group D,some college,standard,0,79,66,67,212,0.7
male,group B,some high school,standard,0,60,50,49,159,0.5
female,group E,high school,standard,0,88,85,86,259,0.9
female,group D,some high school,standard,0,70,87,80,237,0.8
female,group C,associate's degree,standard,10,93,91,94,278,0.9
female,group C,high school,free/reduced,0,23,37,33,93,0.3
male,group D,master's degree,free/reduced,0,76,76,77,229,0.8
female,group C,some college,standard,0,64,72,72,208,0.7
male,group C,bachelor's degree,standard,0,86,77,73,236,0.8
male,group D,some college,standard,0,49,48,46,143,0.5
female,group D,some high school,free/reduced,0,66,67,70,203,0.7
female,group B,master's degree,free/reduced,10,41,54,53,148,0.5
female,group E,some college,standard,0,68,68,69,205,0.7
male,group E,some college,standard,0,72,70,53,195,0.7
male,group D,some high school,free/reduced,0,68,69,68,205,0.7
male,group D,high school,standard,0,74,59,55,188,0.6
male,group A,high school,free/reduced,10,73,72,67,212,0.7
male,group D,high school,free/reduced,10,55,70,59,184,0.6
male,group C,some high school,free/reduced,0,58,60,58,176,0.6
female,group B,high school,free/reduced,10,51,60,60,171,0.6
female,group E,bachelor's degree,standard,0,74,60,68,202,0.7
female,group C,associate's degree,standard,10,71,78,77,226,0.8
male,group C,some high school,standard,0,79,78,71,228,0.8
male,group C,high school,standard,0,74,66,65,205,0.7
male,group C,some high school,free/reduced,10,67,69,66,202,0.7
female,group D,associate's degree,standard,0,76,78,84,238,0.8
male,group C,some high school,free/reduced,0,44,34,34,112,0.4
female,group E,associate's degree,standard,10,69,74,82,225,0.8
male,group B,some high school,standard,0,66,64,62,192,0.6
male,group D,some high school,standard,0,83,86,84,253,0.8
female,group D,some college,standard,10,91,100,100,291,1.0
female,group A,some college,free/reduced,0,35,57,51,143,0.5
male,group D,associate's degree,free/reduced,0,51,52,51,154,0.5
female,group D,some college,free/reduced,0,48,59,59,166,0.6
male,group E,associate's degree,free/reduced,0,59,44,47,150,0.5
male,group C,some college,standard,10,88,77,84,249,0.8
female,group D,high school,standard,0,67,75,77,219,0.7
male,group D,some college,standard,0,56,59,56,171,0.6
female,group B,bachelor's degree,free/reduced,0,78,86,83,247,0.8
female,group E,some high school,standard,0,64,56,55,175,0.6
female,group C,some high school,free/reduced,0,63,74,71,208,0.7
male,group B,some high school,free/reduced,0,65,59,62,186,0.6
male,group A,associate's degree,standard,10,73,70,66,209,0.7
male,group A,high school,standard,0,64,59,62,185,0.6
female,group C,associate's degree,standard,0,66,72,66,204,0.7
female,group A,associate's degree,free/reduced,0,46,65,65,176,0.6
female,group D,some college,free/reduced,0,55,64,67,186,0.6
female,group D,high school,standard,10,53,66,67,186,0.6
female,group B,some college,free/reduced,10,35,48,43,126,0.4
male,group A,some college,standard,10,71,63,64,198,0.7
female,group A,high school,standard,0,74,75,71,220,0.7
male,group C,associate's degree,free/reduced,0,80,78,74,232,0.8
male,group E,some college,standard,0,65,54,54,173,0.6
male,group C,some high school,free/reduced,0,45,44,32,121,0.4
female,group B,associate's degree,standard,0,56,71,76,203,0.7
male,group A,high school,standard,10,82,82,79,243,0.8
female,group B,associate's degree,standard,0,65,63,69,197,0.7
male,group C,associate's degree,standard,0,79,72,76,227,0.8
male,group C,some college,free/reduced,0,54,45,43,142,0.5
male,group D,some college,standard,0,57,60,54,171,0.6
female,group C,associate's degree,free/reduced,0,49,60,55,164,0.5
male,group C,some college,standard,10,84,84,87,255,0.9
male,group B,some college,standard,0,80,69,74,223,0.7
male,group D,associate's degree,standard,10,91,82,84,257,0.9
male,group B,high school,standard,0,91,86,79,256,0.9
male,group B,some high school,standard,10,64,53,54,171,0.6
female,group D,some college,standard,10,83,87,92,262,0.9
male,group D,some high school,free/reduced,0,54,41,37,132,0.4
female,group E,some high school,standard,0,92,78,87,257,0.9
female,group D,some college,standard,10,74,80,91,245,0.8
female,group D,some high school,free/reduced,0,61,69,70,200,0.7
male,group C,high school,standard,0,79,81,73,233,0.8
male,group A,some college,free/reduced,0,46,54,45,145,0.5
female,group C,some college,standard,0,79,93,84,256,0.9
male,group C,associate's degree,standard,10,54,58,58,170,0.6
male,group C,some college,standard,0,57,66,61,184,0.6
female,group C,high school,standard,0,87,88,88,263,0.9
female,group A,bachelor's degree,standard,0,69,72,66,207,0.7
male,group E,some high school,free/reduced,10,30,23,18,71,0.2
female,group D,associate's degree,free/reduced,10,63,76,76,215,0.7
male,group C,some college,standard,0,48,38,37,123,0.4
female,group C,some high school,standard,10,55,64,70,189,0.6
male,group C,high school,standard,0,75,69,65,209,0.7
female,group C,high school,free/reduced,10,70,78,87,235,0.8
male,group E,high school,standard,10,86,82,85,253,0.8
male,group D,some high school,standard,0,78,66,65,209,0.7
male,group A,high school,free/reduced,0,59,56,51,166,0.6
male,group B,master's degree,standard,0,81,79,75,235,0.8
female,group C,associate's degree,standard,10,51,53,62,166,0.6
male,group E,some college,free/reduced,0,78,69,65,212,0.7
female,group B,associate's degree,standard,0,81,76,80,237,0.8
male,group D,high school,free/reduced,0,47,49,46,142,0.5
male,group E,some high school,standard,0,88,80,75,243,0.8
male,group E,associate's degree,standard,10,79,72,75,226,0.8
female,group D,high school,standard,0,55,57,66,178,0.6
male,group A,associate's degree,standard,0,91,90,81,262,0.9
female,group D,high school,standard,10,53,70,75,198,0.7
male,group C,some college,free/reduced,0,43,50,42,135,0.5
male,group C,bachelor's degree,free/reduced,0,65,61,55,181,0.6
female,group D,some college,standard,0,78,85,86,249,0.8
female,group B,some high school,free/reduced,0,56,68,68,192,0.6
male,group C,associate's degree,free/reduced,0,62,45,42,149,0.5
female,group E,high school,standard,0,80,78,72,230,0.8
male,group D,master's degree,free/reduced,10,90,85,91,266,0.9
male,group E,some college,standard,0,95,88,89,272,0.9
male,group D,master's degree,free/reduced,0,86,81,76,243,0.8
female,group C,some high school,standard,0,53,54,52,159,0.5
male,group C,high school,free/reduced,0,47,63,52,162,0.5
female,group C,master's degree,standard,0,64,73,73,210,0.7
male,group A,some college,standard,0,79,78,70,227,0.8
female,group C,high school,free/reduced,10,52,57,58,167,0.6
female,group B,associate's degree,standard,0,61,66,67,194,0.6
female,group B,master's degree,standard,0,50,67,68,185,0.6
male,group A,some college,free/reduced,10,63,57,54,174,0.6
male,group A,high school,free/reduced,0,86,74,68,228,0.8
female,group A,some high school,free/reduced,0,27,43,36,106,0.4
female,group B,some college,free/reduced,0,44,54,53,151,0.5
male,group D,some college,free/reduced,10,60,60,59,179,0.6
female,group D,some high school,free/reduced,10,43,62,65,170,0.6
female,group A,some high school,free/reduced,0,66,69,77,212,0.7
female,group D,associate's degree,free/reduced,0,79,89,94,262,0.9
female,group E,associate's degree,standard,10,100,100,100,300,1.0
female,group E,high school,standard,0,65,77,71,213,0.7
male,group B,associate's degree,standard,10,86,99,100,285,1.0
male,group D,associate's degree,free/reduced,0,47,51,46,144,0.5
female,group C,associate's degree,standard,0,62,72,71,205,0.7
male,group C,some high school,standard,0,56,52,48,156,0.5
male,group B,some high school,standard,10,65,61,63,189,0.6
male,group C,bachelor's degree,standard,10,68,69,72,209,0.7
male,group B,high school,standard,0,83,79,82,244,0.8
female,group B,some college,standard,10,55,74,69,198,0.7
male,group B,some high school,standard,10,57,58,62,177,0.6
male,group E,associate's degree,standard,0,100,83,91,274,0.9
female,group C,some college,free/reduced,0,34,52,55,141,0.5
female,group C,high school,standard,0,52,65,63,180,0.6
male,group C,high school,free/reduced,10,85,81,82,248,0.8
female,group B,some college,standard,0,57,72,69,198,0.7
female,group D,associate's degree,free/reduced,10,48,68,71,187,0.6
female,group C,high school,standard,0,52,60,56,168,0.6
male,group C,some college,free/reduced,0,43,44,42,129,0.4
male,group C,master's degree,standard,0,72,77,73,222,0.7
male,group C,associate's degree,standard,0,76,70,64,210,0.7
female,group E,high school,free/reduced,0,54,59,49,162,0.5
female,group C,associate's degree,standard,0,66,74,75,215,0.7
male,group B,some high school,free/reduced,0,50,39,44,133,0.4
male,group E,some college,free/reduced,0,48,45,45,138,0.5
male,group C,associate's degree,standard,10,64,62,58,184,0.6
female,group D,high school,standard,10,35,57,59,151,0.5
male,group D,some college,standard,0,72,71,69,212,0.7
male,group C,high school,standard,0,59,44,47,150,0.5
male,group C,associate's degree,free/reduced,0,84,79,75,238,0.8
female,group C,high school,standard,0,54,71,66,191,0.6
male,group B,some college,standard,0,73,63,57,193,0.6
male,group D,some high school,standard,0,81,78,78,237,0.8
male,group D,master's degree,standard,10,70,64,62,196,0.7
male,group B,master's degree,free/reduced,0,56,42,46,144,0.5
female,group C,some college,standard,10,71,86,90,247,0.8
male,group C,master's degree,free/reduced,0,55,50,50,155,0.5
male,group C,high school,standard,0,41,47,42,130,0.4
male,group C,bachelor's degree,free/reduced,0,78,70,76,224,0.7
male,group B,associate's degree,standard,10,82,84,77,243,0.8
female,group B,some high school,standard,0,77,80,77,234,0.8
male,group C,some college,standard,10,55,51,53,159,0.5
female,group C,master's degree,standard,10,74,82,84,240,0.8
male,group B,high school,standard,0,56,50,47,153,0.5
male,group B,associate's degree,standard,10,63,64,63,190,0.6
female,group D,associate's degree,free/reduced,0,46,60,54,160,0.5
male,group E,high school,standard,10,87,76,74,237,0.8
male,group A,some college,free/reduced,10,62,59,63,184,0.6
male,group E,some high school,free/reduced,0,81,75,71,227,0.8
male,group C,associate's degree,standard,0,73,68,62,203,0.7
female,group B,high school,free/reduced,0,45,62,57,164,0.5
female,group C,some high school,free/reduced,10,43,61,62,166,0.6
female,group C,some college,standard,0,61,82,75,218,0.7
female,group C,high school,free/reduced,0,50,63,66,179,0.6
female,group E,associate's degree,standard,10,71,65,74,210,0.7
female,group D,some college,standard,0,46,53,57,156,0.5
male,group B,associate's degree,standard,10,71,70,69,210,0.7
female,group D,some college,standard,0,60,67,69,196,0.7
male,group C,bachelor's degree,standard,10,92,91,92,275,0.9
female,group D,associate's degree,standard,10,85,97,98,280,0.9
male,group D,some college,standard,0,67,60,58,185,0.6
male,group C,high school,standard,0,74,56,59,189,0.6
male,group D,some high school,free/reduced,10,61,59,60,180,0.6
female,group C,bachelor's degree,standard,10,66,73,81,220,0.7
male,group B,some college,standard,0,72,70,69,211,0.7
male,group C,some college,standard,10,86,86,80,252,0.8
female,group D,some high school,standard,0,59,64,60,183,0.6
male,group C,some high school,free/reduced,10,52,65,64,181,0.6
female,group D,high school,standard,0,63,64,66,193,0.6
male,group D,high school,free/reduced,0,50,56,48,154,0.5
female,group C,master's degree,standard,0,52,69,68,189,0.6
female,group C,some college,free/reduced,10,72,99,98,269,0.9
male,group B,some college,standard,0,71,62,57,190,0.6
male,group D,high school,standard,10,82,76,82,240,0.8
female,group A,master's degree,standard,0,77,76,74,227,0.8
male,group A,high school,standard,10,88,78,80,246,0.8
male,group B,bachelor's degree,standard,10,69,81,73,223,0.7
male,group B,some college,free/reduced,10,80,81,83,244,0.8
female,group E,some college,standard,0,84,92,89,265,0.9
female,group B,some high school,free/reduced,0,57,81,68,206,0.7
male,group C,some college,free/reduced,10,67,57,64,188,0.6
female,group C,some high school,standard,0,52,61,62,175,0.6
male,group D,high school,standard,0,62,65,64,191,0.6
male,group C,some college,standard,0,63,59,55,177,0.6
male,group C,bachelor's degree,standard,10,84,91,91,266,0.9
female,group D,associate's degree,free/reduced,0,72,87,84,243,0.8
female,group B,high school,standard,10,49,59,55,163,0.5
female,group C,associate's degree,standard,10,67,68,79,214,0.7
male,group C,high school,standard,0,65,72,68,205,0.7
male,group B,associate's degree,free/reduced,10,73,71,75,219,0.7
female,group C,associate's degree,standard,10,69,84,84,237,0.8
female,group B,high school,standard,0,80,87,93,260,0.9
male,group B,high school,standard,10,79,74,78,231,0.8
male,group D,bachelor's degree,standard,0,85,84,87,256,0.9
male,group D,some high school,free/reduced,10,55,61,64,180,0.6
male,group D,some high school,free/reduced,0,44,42,48,134,0.4
female,group A,some high school,standard,0,61,77,73,211,0.7
female,group C,bachelor's degree,standard,10,72,73,82,227,0.8
female,group D,high school,standard,0,80,87,80,247,0.8
male,group E,some college,standard,0,91,84,75,250,0.8
female,group D,high school,standard,0,52,56,60,168,0.6
female,group C,associate's degree,standard,10,87,98,100,285,1.0
male,group B,bachelor's degree,standard,0,58,56,55,169,0.6
female,group C,high school,free/reduced,0,60,81,79,220,0.7
male,group C,some college,standard,0,47,45,34,126,0.4
male,group C,some college,standard,10,59,64,57,180,0.6
female,group C,high school,standard,0,62,78,76,216,0.7
male,group E,associate's degree,standard,0,82,73,76,231,0.8
female,group B,associate's degree,free/reduced,0,45,68,60,173,0.6
female,group B,some college,standard,0,75,77,71,223,0.7
female,group A,some high school,standard,0,48,55,51,154,0.5
female,group C,bachelor's degree,free/reduced,10,37,48,49,134,0.4
female,group D,bachelor's degree,standard,0,58,71,78,207,0.7
female,group C,some college,standard,0,73,85,79,237,0.8
female,group C,some high school,standard,0,55,61,53,169,0.6
female,group A,high school,free/reduced,0,24,45,41,110,0.4
male,group C,associate's degree,free/reduced,0,44,57,50,151,0.5
male,group D,bachelor's degree,standard,0,54,41,39,134,0.4
female,group C,high school,free/reduced,0,45,60,51,156,0.5
female,group D,associate's degree,standard,0,56,70,67,193,0.6
female,group B,some high school,standard,10,69,83,79,231,0.8
male,group C,some college,standard,10,49,54,52,155,0.5
male,group C,high school,free/reduced,0,53,46,43,142,0.5
female,group B,bachelor's degree,standard,10,85,91,100,276,0.9
female,group D,some college,standard,10,73,77,82,232,0.8
male,group C,high school,standard,0,76,65,63,204,0.7
male,group C,high school,standard,0,68,81,78,227,0.8
female,group C,master's degree,standard,0,89,100,100,289,1.0
male,group B,associate's degree,standard,10,56,69,63,188,0.6
male,group C,some college,standard,0,55,58,50,163,0.5
male,group D,some high school,free/reduced,10,73,72,70,215,0.7
male,group D,high school,standard,0,86,88,84,258,0.9
male,group D,some high school,free/reduced,10,75,76,72,223,0.7
male,group D,high school,free/reduced,10,77,61,68,206,0.7
male,group D,bachelor's degree,free/reduced,10,76,70,75,221,0.7
female,group C,some college,free/reduced,0,62,66,74,202,0.7
male,group C,some college,standard,0,87,85,80,252,0.8
female,group C,high school,free/reduced,0,64,64,61,189,0.6
male,group C,bachelor's degree,standard,0,87,84,80,251,0.8
male,group E,some high school,free/reduced,10,75,68,69,212,0.7
male,group C,some college,free/reduced,0,45,59,51,155,0.5
female,group D,some college,standard,0,41,48,52,141,0.5
male,group C,associate's degree,standard,0,55,52,48,155,0.5
female,group B,some college,free/reduced,0,50,61,58,169,0.6
male,group C,some high school,standard,10,89,93,87,269,0.9
male,group C,associate's degree,standard,0,77,73,70,220,0.7
female,group C,high school,free/reduced,0,62,78,68,208,0.7
male,group D,some high school,free/reduced,0,59,55,55,169,0.6
male,group D,some college,free/reduced,0,59,47,48,154,0.5
male,group E,high school,free/reduced,0,86,80,79,245,0.8
female,group C,high school,free/reduced,0,50,60,64,174,0.6
female,group C,high school,free/reduced,10,57,67,69,193,0.6
female,group B,high school,free/reduced,0,48,57,57,162,0.5
female,group C,high school,free/reduced,0,71,83,79,233,0.8
male,group D,high school,standard,0,66,67,63,196,0.7
male,group D,some college,free/reduced,0,61,62,62,185,0.6
female,group A,some high school,standard,0,73,88,83,244,0.8
male,group B,high school,free/reduced,0,59,56,52,167,0.6
male,group B,associate's degree,standard,10,80,80,81,241,0.8
male,group D,associate's degree,free/reduced,0,58,53,62,173,0.6
male,group B,bachelor's degree,standard,10,62,60,60,182,0.6
male,group C,some high school,standard,0,58,53,48,159,0.5
female,group C,high school,standard,0,49,66,63,178,0.6
female,group D,associate's degree,standard,0,60,71,68,199,0.7
female,group E,associate's degree,standard,0,83,93,92,268,0.9
female,group B,high school,free/reduced,10,58,71,71,200,0.7
male,group B,some college,standard,0,57,54,48,159,0.5
male,group B,some college,standard,10,65,60,59,184,0.6
female,group C,bachelor's degree,standard,0,69,92,88,249,0.8
male,group E,some college,standard,0,79,71,64,214,0.7
female,group D,bachelor's degree,free/reduced,10,67,87,92,246,0.8
female,group C,some college,standard,0,66,82,82,230,0.8
male,group D,associate's degree,standard,10,80,85,78,243,0.8
male,group D,some high school,free/reduced,10,52,51,52,155,0.5
male,group C,master's degree,free/reduced,10,74,87,82,243,0.8
male,group E,some high school,free/reduced,10,77,66,70,213,0.7
male,group C,some high school,standard,0,69,66,63,198,0.7
male,group B,associate's degree,free/reduced,0,41,46,42,129,0.4
male,group B,some college,standard,0,80,82,76,238,0.8
female,group E,bachelor's degree,free/reduced,10,79,86,81,246,0.8
female,group D,associate's degree,standard,0,61,70,70,201,0.7
female,group E,some college,standard,10,80,80,82,242,0.8
male,group C,high school,standard,0,59,55,52,166,0.6
female,group B,high school,free/reduced,0,39,57,54,150,0.5
female,group C,high school,free/reduced,10,46,67,58,171,0.6
male,group D,some college,standard,10,65,67,73,205,0.7
male,group E,high school,standard,10,86,75,70,231,0.8
male,group B,some college,standard,10,54,49,54,157,0.5
female,group E,high school,standard,10,87,95,99,281,0.9
male,group E,some college,free/reduced,0,62,57,51,170,0.6
female,group D,some college,standard,0,71,70,77,218,0.7
male,group D,some college,free/reduced,10,53,52,50,155,0.5
female,group A,bachelor's degree,standard,0,83,92,95,270,0.9
female,group B,associate's degree,free/reduced,10,83,88,95,266,0.9
male,group D,master's degree,standard,0,81,77,75,233,0.8
female,group D,bachelor's degree,standard,0,77,73,78,228,0.8
male,group C,associate's degree,standard,10,79,61,66,206,0.7
male,group C,some college,free/reduced,0,44,55,48,147,0.5
male,group C,high school,standard,0,63,68,55,186,0.6
male,group C,high school,free/reduced,10,69,70,74,213,0.7
male,group C,some college,standard,0,56,60,55,171,0.6
female,group D,associate's degree,free/reduced,0,57,64,75,196,0.7
female,group C,associate's degree,standard,0,77,84,83,244,0.8
female,group D,some high school,standard,0,69,82,82,233,0.8
male,group C,some high school,standard,0,70,71,70,211,0.7
male,group B,associate's degree,free/reduced,10,50,45,48,143,0.5
male,group C,master's degree,standard,0,96,92,91,279,0.9
female,group A,high school,standard,0,79,83,85,247,0.8
female,group C,master's degree,standard,10,99,100,98,297,1.0
male,group C,high school,standard,0,74,63,66,203,0.7
female,group B,some college,standard,0,54,70,70,194,0.6
male,group C,some college,standard,0,82,73,74,229,0.8
female,group C,associate's degree,standard,0,59,67,67,193,0.6
male,group C,some college,free/reduced,0,69,67,61,197,0.7
female,group B,associate's degree,standard,0,52,55,58,165,0.6
male,group C,some college,standard,0,59,48,48,155,0.5
male,group D,bachelor's degree,standard,0,73,76,69,218,0.7
male,group D,some high school,standard,0,56,55,58,169,0.6
male,group C,associate's degree,standard,10,100,85,93,278,0.9
male,group E,some high school,standard,10,82,74,73,229,0.8
male,group C,some college,free/reduced,0,42,37,44,123,0.4
male,group C,high school,standard,0,77,67,65,209,0.7
female,group A,bachelor's degree,standard,10,88,98,100,286,1.0
male,group A,associate's degree,standard,10,80,82,74,236,0.8
male,group B,associate's degree,standard,10,89,86,84,259,0.9
female,group D,some high school,standard,0,87,88,92,267,0.9
male,group D,some college,standard,0,76,68,64,208,0.7
male,group B,some high school,standard,10,50,56,56,162,0.5
female,group D,bachelor's degree,free/reduced,0,60,66,65,191,0.6
female,group B,master's degree,standard,0,69,75,77,221,0.7
male,group B,associate's degree,standard,0,58,59,50,167,0.6
female,group B,some college,free/reduced,0,61,76,74,211,0.7
female,group B,bachelor's degree,free/reduced,0,50,65,68,183,0.6
female,group C,bachelor's degree,standard,0,73,78,80,231,0.8
male,group C,associate's degree,standard,10,68,69,75,212,0.7
male,group B,some high school,standard,0,78,72,69,219,0.7
female,group C,associate's degree,standard,0,45,58,49,152,0.5
male,group D,some high school,standard,0,80,70,77,227,0.8
female,group C,associate's degree,standard,0,58,62,63,183,0.6
male,group E,some college,free/reduced,0,89,80,79,248,0.8
male,group A,bachelor's degree,standard,0,71,74,68,213,0.7
female,group D,some high school,standard,10,75,90,91,256,0.9
male,group D,some college,free/reduced,10,73,61,66,200,0.7
female,group D,high school,free/reduced,10,63,72,75,210,0.7
male,group C,some high school,free/reduced,0,63,70,59,192,0.6
female,group D,bachelor's degree,standard,0,93,100,97,290,1.0
male,group A,bachelor's degree,standard,10,83,68,76,227,0.8
male,group C,associate's degree,standard,10,63,64,66,193,0.6
male,group C,bachelor's degree,free/reduced,10,78,83,78,239,0.8
male,group E,high school,free/reduced,0,72,78,69,219,0.7
female,group E,some high school,standard,10,94,100,100,294,1.0
female,group C,high school,free/reduced,10,54,71,73,198,0.7
male,group E,associate's degree,standard,0,97,79,76,252,0.8
male,group B,some high school,standard,0,63,63,64,190,0.6
female,group B,some college,standard,0,73,75,71,219,0.7
female,group D,master's degree,free/reduced,10,60,78,78,216,0.7
female,group C,bachelor's degree,standard,10,73,76,79,228,0.8
male,group B,associate's degree,standard,0,78,77,73,228,0.8
female,group C,associate's degree,standard,0,53,66,64,183,0.6
male,group C,some college,standard,0,46,49,43,138,0.5
male,group E,some high school,standard,10,61,59,61,181,0.6
male,group D,some college,free/reduced,0,41,49,40,130,0.4
male,group E,high school,standard,10,81,75,73,229,0.8
female,group A,high school,standard,10,71,85,88,244,0.8
female,group D,associate's degree,free/reduced,0,50,70,67,187,0.6
female,group C,some college,standard,0,63,68,69,200,0.7
female,group C,some high school,standard,0,49,66,58,173,0.6
female,group B,some college,standard,10,65,75,74,214,0.7
female,group C,some college,free/reduced,0,53,64,59,176,0.6
male,group C,some high school,standard,0,67,52,57,176,0.6
female,group B,associate's degree,standard,10,78,83,80,241,0.8
male,group B,some college,free/reduced,0,66,73,74,213,0.7
male,group C,high school,free/reduced,0,74,72,63,209,0.7
male,group C,associate's degree,standard,0,79,80,79,238,0.8
male,group C,some college,standard,0,81,64,65,210,0.7
female,group C,some college,standard,0,71,88,84,243,0.8
male,group D,associate's degree,free/reduced,10,80,79,77,236,0.8
female,group E,high school,standard,10,69,79,82,230,0.8
female,group B,some college,standard,10,47,61,70,178,0.6
female,group B,associate's degree,standard,10,81,89,92,262,0.9
female,group D,associate's degree,standard,0,82,96,91,269,0.9
male,group C,master's degree,free/reduced,10,88,90,89,267,0.9
male,group E,associate's degree,standard,0,100,100,93,293,1.0
male,group C,high school,free/reduced,10,56,54,47,157,0.5
male,group D,some high school,free/reduced,0,72,81,81,234,0.8
female,group B,high school,free/reduced,0,43,57,50,150,0.5
male,group D,some college,standard,0,76,71,77,224,0.7
female,group B,some college,standard,10,80,97,97,274,0.9
male,group C,associate's degree,free/reduced,0,63,55,57,175,0.6
male,group E,associate's degree,standard,10,84,75,73,232,0.8
female,group B,some high school,standard,10,69,83,84,236,0.8
female,group D,some high school,standard,10,53,61,71,185,0.6
female,group C,bachelor's degree,standard,10,61,68,73,202,0.7
male,group D,associate's degree,standard,0,82,74,65,221,0.7
male,group D,bachelor's degree,standard,0,85,73,82,240,0.8
female,group A,some college,standard,0,60,71,61,192,0.6
female,group B,associate's degree,standard,0,55,57,58,170,0.6
male,group B,high school,standard,0,64,62,57,183,0.6
female,group C,associate's degree,standard,0,66,67,63,196,0.7
male,group C,associate's degree,standard,0,59,67,58,184,0.6
female,group C,some high school,standard,10,87,100,100,287,1.0
female,group E,some high school,standard,0,78,84,84,246,0.8
female,group E,associate's degree,free/reduced,10,84,100,95,279,0.9
female,group E,some college,standard,0,99,93,99,291,1.0
male,group D,some college,standard,10,76,84,84,244,0.8
female,group B,some college,standard,0,53,56,58,167,0.6
male,group E,master's degree,standard,0,87,74,79,240,0.8
female,group C,some high school,standard,0,81,87,85,253,0.8
male,group C,associate's degree,free/reduced,0,65,59,51,175,0.6
female,group D,some college,free/reduced,0,67,79,76,222,0.7
male,group D,some college,free/reduced,0,60,56,55,171,0.6
male,group C,some college,free/reduced,0,54,56,49,159,0.5
male,group B,associate's degree,standard,0,65,58,62,185,0.6
male,group E,some college,standard,0,74,66,66,206,0.7
male,group D,high school,standard,10,91,79,78,248,0.8
female,group D,associate's degree,free/reduced,0,61,70,70,201,0.7
female,group C,master's degree,free/reduced,0,42,49,53,144,0.5
male,group B,high school,free/reduced,0,50,40,39,129,0.4
female,group B,some high school,standard,0,67,78,73,218,0.7
male,group B,associate's degree,standard,0,80,76,73,229,0.8
female,group D,some college,standard,0,66,78,80,224,0.7
female,group B,high school,standard,0,53,57,57,167,0.6
female,group C,associate's degree,standard,10,78,84,86,248,0.8
male,group B,some college,free/reduced,10,76,79,77,232,0.8
female,group C,some college,standard,0,64,64,63,191,0.6
male,group D,some high school,standard,0,96,88,88,272,0.9
female,group B,some high school,standard,0,73,82,78,233,0.8
male,group C,master's degree,standard,0,64,57,60,181,0.6
female,group B,master's degree,standard,0,79,84,82,245,0.8
female,group A,associate's degree,standard,0,59,74,73,206,0.7
male,group B,bachelor's degree,free/reduced,0,69,62,59,190,0.6
male,group D,master's degree,standard,0,100,88,94,282,0.9
female,group B,master's degree,free/reduced,0,50,52,63,165,0.6
male,group D,high school,free/reduced,0,75,70,62,207,0.7
male,group C,some high school,standard,0,58,56,55,169,0.6
male,group C,master's degree,free/reduced,0,50,51,46,147,0.5
female,group B,high school,standard,10,41,43,44,128,0.4
female,group C,bachelor's degree,standard,0,58,69,70,197,0.7
female,group D,bachelor's degree,standard,0,65,71,71,207,0.7
female,group E,some high school,free/reduced,0,56,61,54,171,0.6
male,group C,bachelor's degree,standard,0,69,63,58,190,0.6
female,group C,high school,standard,0,67,85,77,229,0.8
male,group B,some high school,free/reduced,10,66,65,63,194,0.6
female,group E,bachelor's degree,standard,0,75,85,80,240,0.8
female,group C,high school,standard,10,62,85,83,230,0.8
male,group B,some high school,free/reduced,0,65,69,63,197,0.7
female,group C,some high school,standard,0,58,72,70,200,0.7
female,group B,bachelor's degree,standard,0,70,73,77,220,0.7
female,group C,associate's degree,free/reduced,10,68,72,76,216,0.7
male,group D,some high school,standard,0,95,83,87,265,0.9
female,group C,some high school,standard,0,58,58,57,173,0.6
male,group D,some high school,free/reduced,0,40,42,42,124,0.4
male,group D,high school,free/reduced,10,56,51,51,158,0.5
female,group C,bachelor's degree,standard,0,51,63,66,180,0.6
female,group B,some college,standard,0,55,62,62,179,0.6
female,group D,associate's degree,standard,0,60,67,65,192,0.6
male,group D,bachelor's degree,standard,0,76,62,68,206,0.7
male,group E,some college,standard,0,82,77,65,224,0.7
male,group D,some college,standard,0,80,70,71,221,0.7
male,group C,some college,standard,10,56,48,55,159,0.5
male,group D,some high school,standard,0,72,76,72,220,0.7
male,group C,master's degree,standard,0,79,75,69,223,0.7
female,group B,some college,standard,0,75,79,79,233,0.8
male,group C,high school,free/reduced,0,42,43,38,123,0.4
male,group C,some college,standard,10,62,62,64,188,0.6
female,group B,high school,standard,0,59,69,70,198,0.7
male,group C,bachelor's degree,free/reduced,0,58,62,54,174,0.6
male,group E,master's degree,free/reduced,0,70,57,63,190,0.6
male,group D,some high school,standard,10,87,79,73,239,0.8
female,group B,high school,standard,0,69,73,69,211,0.7
male,group D,some college,standard,0,77,72,73,222,0.7
female,group E,associate's degree,standard,0,68,74,70,212,0.7
male,group C,some college,standard,10,83,89,90,262,0.9
female,group A,some college,standard,0,71,77,79,227,0.8
male,group C,some college,standard,10,63,63,57,183,0.6
male,group E,associate's degree,standard,10,93,80,85,258,0.9
male,group C,high school,standard,0,62,49,49,160,0.5
female,group C,high school,standard,10,82,98,98,278,0.9
female,group B,some high school,standard,0,55,60,61,176,0.6
male,group A,bachelor's degree,free/reduced,0,51,52,51,154,0.5
male,group D,associate's degree,standard,10,88,86,83,257,0.9
female,group C,associate's degree,free/reduced,10,69,92,98,259,0.9
female,group C,some high school,standard,0,52,66,64,182,0.6
male,group B,some college,free/reduced,0,55,47,41,143,0.5
female,group B,bachelor's degree,standard,0,78,95,93,266,0.9
female,group A,high school,standard,10,65,70,74,209,0.7
female,group D,some college,standard,10,78,74,81,233,0.8
female,group D,some high school,standard,0,42,38,48,128,0.4
female,group C,some college,free/reduced,10,34,47,43,124,0.4
male,group D,high school,free/reduced,0,77,64,72,213,0.7
male,group D,some college,free/reduced,0,62,51,49,162,0.5
female,group B,some high school,free/reduced,0,54,57,60,171,0.6
female,group D,associate's degree,free/reduced,0,65,71,74,210,0.7
female,group B,associate's degree,standard,10,76,77,83,236,0.8
male,group B,high school,standard,10,63,57,58,178,0.6
female,group B,high school,free/reduced,0,59,72,66,197,0.7
male,group A,some college,free/reduced,0,48,42,39,129,0.4
male,group E,associate's degree,free/reduced,0,51,41,42,134,0.4
male,group C,associate's degree,standard,0,71,75,71,217,0.7
female,group C,some college,free/reduced,10,64,70,67,201,0.7
female,group C,some college,free/reduced,0,55,65,71,191,0.6
female,group D,bachelor's degree,standard,10,92,100,100,292,1.0
male,group E,master's degree,free/reduced,0,55,55,53,163,0.5
male,group A,associate's degree,free/reduced,10,81,86,90,257,0.9
male,group C,some college,standard,0,78,78,72,228,0.8
female,group C,some high school,standard,0,60,80,79,219,0.7
female,group C,some college,standard,0,76,92,90,258,0.9
female,group A,some high school,standard,0,57,59,64,180,0.6
male,group A,some high school,standard,10,65,75,68,208,0.7
female,group D,master's degree,free/reduced,10,78,100,100,278,0.9
male,group C,some college,free/reduced,0,48,52,52,152,0.5
male,group C,associate's degree,free/reduced,0,61,63,61,185,0.6
female,group E,associate's degree,standard,10,62,78,73,213,0.7
male,group C,bachelor's degree,standard,0,69,68,67,204,0.7
male,group B,bachelor's degree,standard,10,62,61,61,184,0.6
male,group C,high school,free/reduced,0,46,43,43,132,0.4
female,group C,some high school,standard,10,55,61,64,180,0.6
male,group C,master's degree,standard,0,66,57,64,187,0.6
male,group D,associate's degree,free/reduced,0,61,59,62,182,0.6
male,group B,some high school,standard,0,64,73,62,199,0.7
male,group B,some high school,free/reduced,0,66,49,53,168,0.6
male,group A,associate's degree,standard,0,79,84,79,242,0.8
female,group C,high school,standard,0,82,91,90,263,0.9
female,group E,associate's degree,free/reduced,0,61,68,65,194,0.6
female,group C,some high school,standard,0,85,90,88,263,0.9
male,group E,high school,standard,0,88,91,84,263,0.9
male,group A,some high school,free/reduced,0,29,38,27,94,0.3
male,group A,bachelor's degree,free/reduced,0,58,47,46,151,0.5
male,group C,high school,free/reduced,10,71,74,71,216,0.7
male,group C,some high school,free/reduced,0,72,76,71,219,0.7
female,group C,some college,standard,0,76,81,81,238,0.8
female,group A,high school,free/reduced,0,42,53,48,143,0.5
male,group B,high school,standard,0,88,87,80,255,0.9
male,group D,some high school,free/reduced,0,76,71,65,212,0.7
male,group C,some college,standard,0,54,42,50,146,0.5
female,group D,associate's degree,free/reduced,10,68,84,83,235,0.8
female,group C,associate's degree,free/reduced,0,62,73,67,202,0.7
male,group B,some college,standard,10,54,48,49,151,0.5
female,group D,some college,standard,0,54,63,59,176,0.6
male,group D,master's degree,standard,0,67,68,67,202,0.7
male,group B,high school,standard,0,67,54,56,177,0.6
female,group C,associate's degree,free/reduced,10,49,63,56,168,0.6
male,group C,some high school,standard,0,81,77,74,232,0.8
female,group E,master's degree,free/reduced,10,55,58,64,177,0.6
female,group A,associate's degree,standard,10,57,54,61,172,0.6
female,group B,some high school,standard,0,69,77,67,213,0.7
female,group D,bachelor's degree,standard,0,85,90,88,263,0.9
male,group B,associate's degree,standard,10,84,86,79,249,0.8
male,group B,master's degree,standard,10,63,66,72,201,0.7
female,group E,high school,standard,10,65,60,67,192,0.6
male,group C,some college,standard,0,65,60,55,180,0.6
male,group B,bachelor's degree,standard,10,65,62,64,191,0.6
male,group C,master's degree,free/reduced,0,70,71,70,211,0.7
male,group C,high school,standard,0,80,66,65,211,0.7
male,group D,some high school,standard,10,89,82,84,255,0.9
female,group B,some college,standard,0,89,91,95,275,0.9
male,group C,master's degree,standard,0,77,76,70,223,0.7
male,group C,some high school,standard,10,69,67,66,202,0.7
female,group A,high school,standard,10,63,65,66,194,0.6
female,group B,high school,free/reduced,0,68,84,81,233,0.8
male,group D,some high school,standard,0,63,67,59,189,0.6
male,group C,some college,free/reduced,0,73,78,69,220,0.7
female,group C,bachelor's degree,standard,0,71,78,86,235,0.8
female,group B,some high school,standard,0,60,64,66,190,0.6
male,group E,some high school,free/reduced,10,72,48,52,172,0.6
male,group C,some college,standard,0,91,87,86,264,0.9
female,group A,associate's degree,free/reduced,0,71,83,80,234,0.8
male,group A,associate's degree,free/reduced,0,59,58,60,177,0.6
male,group E,some college,standard,0,85,66,67,218,0.7
female,group C,high school,standard,0,77,81,80,238,0.8
female,group C,associate's degree,free/reduced,0,45,49,49,143,0.5
female,group B,bachelor's degree,standard,0,92,95,95,282,0.9
male,group C,high school,free/reduced,10,51,55,54,160,0.5
male,group A,some college,standard,0,75,70,67,212,0.7
male,group A,some college,standard,0,79,81,75,235,0.8
male,group E,some college,free/reduced,0,61,54,54,169,0.6
male,group E,high school,free/reduced,0,57,40,43,140,0.5
male,group B,some college,standard,10,57,59,68,184,0.6
female,group C,some high school,standard,0,44,51,46,141,0.5
male,group B,associate's degree,standard,0,94,87,87,268,0.9
male,group A,some college,free/reduced,0,55,62,57,174,0.6
female,group D,high school,free/reduced,0,74,82,84,240,0.8
male,group C,bachelor's degree,standard,0,56,62,63,181,0.6
female,group D,associate's degree,free/reduced,0,71,88,89,248,0.8
male,group D,bachelor's degree,standard,0,89,79,76,244,0.8
female,group C,associate's degree,free/reduced,10,60,83,80,223,0.7
female,group E,some college,standard,0,75,66,64,205,0.7
female,group B,associate's degree,standard,0,49,56,54,159,0.5
male,group C,some high school,free/reduced,0,52,44,40,136,0.5
male,group C,some college,standard,0,75,71,66,212,0.7
female,group C,bachelor's degree,standard,0,55,66,64,185,0.6
male,group C,high school,free/reduced,10,55,61,60,176,0.6
female,group D,bachelor's degree,standard,10,60,65,65,190,0.6
male,group B,high school,free/reduced,0,53,58,48,159,0.5
male,group C,some high school,standard,0,64,50,51,165,0.6
male,group E,associate's degree,standard,0,79,72,73,224,0.7
male,group C,high school,standard,0,64,59,51,174,0.6
male,group C,bachelor's degree,standard,0,81,84,80,245,0.8
female,group E,high school,standard,0,73,70,69,212,0.7
male,group D,associate's degree,standard,10,75,67,65,207,0.7
female,group A,high school,standard,10,77,86,84,247,0.8
female,group D,associate's degree,standard,0,76,79,86,241,0.8
female,group B,associate's degree,free/reduced,0,63,70,75,208,0.7
male,group C,some college,standard,10,71,75,77,223,0.7
male,group C,high school,standard,10,66,70,71,207,0.7
female,group E,some high school,standard,0,68,79,79,226,0.8
female,group B,some college,standard,0,51,53,53,157,0.5
male,group C,some college,standard,10,72,62,61,195,0.7
female,group D,associate's degree,standard,0,71,82,83,236,0.8
male,group B,associate's degree,standard,10,81,78,81,240,0.8
female,group C,associate's degree,standard,10,97,100,100,297,1.0
female,group D,associate's degree,free/reduced,0,69,74,75,218,0.7
male,group A,some college,standard,0,91,84,80,255,0.9
male,group C,some college,standard,10,70,57,59,186,0.6
female,group E,associate's degree,standard,0,96,97,94,287,1.0
male,group B,high school,standard,0,93,83,80,256,0.9
male,group A,associate's degree,standard,0,67,64,67,198,0.7
male,group D,some college,standard,0,92,82,82,256,0.9
female,group A,bachelor's degree,free/reduced,10,67,83,84,234,0.8
female,group C,some college,standard,0,46,60,60,166,0.6
male,group E,bachelor's degree,standard,0,98,83,79,260,0.9
male,group D,some college,standard,0,90,78,82,250,0.8
female,group D,some high school,standard,0,63,66,68,197,0.7
male,group B,high school,standard,0,58,50,47,155,0.5
male,group C,some high school,standard,10,94,92,82,268,0.9
male,group E,high school,free/reduced,10,72,75,75,222,0.7
female,group C,some college,standard,0,80,92,94,266,0.9
male,group C,some college,standard,0,86,79,77,242,0.8
male,group B,high school,standard,0,66,59,57,182,0.6
male,group B,some college,standard,0,83,83,75,241,0.8
female,group B,high school,standard,0,62,71,72,205,0.7
female,group C,high school,free/reduced,10,60,74,81,215,0.7
male,group D,some college,free/reduced,10,51,52,50,153,0.5
male,group C,some high school,standard,0,49,46,47,142,0.5
male,group E,high school,standard,0,58,47,40,145,0.5
female,group C,associate's degree,free/reduced,0,52,58,56,166,0.6
male,group D,some high school,free/reduced,10,83,76,74,233,0.8
female,group B,bachelor's degree,standard,0,67,67,73,207,0.7
male,group B,master's degree,standard,0,73,77,75,225,0.8
male,group D,some high school,free/reduced,0,45,49,48,142,0.5
female,group C,some college,standard,10,69,68,69,206,0.7
male,group B,master's degree,standard,0,72,73,72,217,0.7
female,group D,master's degree,free/reduced,10,54,73,76,203,0.7
male,group C,some college,standard,0,88,78,78,244,0.8
female,group C,high school,free/reduced,10,26,53,53,132,0.4
female,group D,associate's degree,standard,0,77,84,86,247,0.8
male,group E,master's degree,standard,10,84,76,79,239,0.8
female,group E,some college,standard,10,76,80,84,240,0.8
female,group C,master's degree,standard,10,71,84,91,246,0.8
male,group C,associate's degree,free/reduced,10,63,73,68,204,0.7
female,group D,some high school,free/reduced,10,55,68,67,190,0.6
male,group C,some high school,free/reduced,0,50,43,48,141,0.5
female,group B,some college,standard,0,50,45,50,145,0.5
male,group B,some college,standard,0,65,55,52,172,0.6
female,group A,some high school,standard,10,62,67,69,198,0.7
male,group A,associate's degree,standard,0,67,71,59,197,0.7
female,group D,some college,free/reduced,0,61,67,67,195,0.7
female,group E,associate's degree,standard,0,77,70,70,217,0.7
male,group E,high school,standard,0,87,69,65,221,0.7
male,group C,high school,standard,0,73,57,56,186,0.6
male,group D,bachelor's degree,free/reduced,10,60,61,60,181,0.6
male,group D,master's degree,free/reduced,0,81,79,81,241,0.8
male,group D,some college,free/reduced,0,60,71,60,191,0.6
male,group D,high school,free/reduced,10,76,84,82,242,0.8
male,group C,bachelor's degree,standard,0,76,72,70,218,0.7
female,group C,some high school,standard,0,65,76,66,207,0.7
female,group E,some college,standard,10,99,97,94,290,1.0
female,group D,associate's degree,standard,0,80,83,86,249,0.8
female,group A,high school,free/reduced,0,58,69,67,194,0.6
male,group E,master's degree,standard,0,76,71,74,221,0.7
male,group B,high school,free/reduced,0,45,42,37,124,0.4
male,group E,some high school,free/reduced,0,75,65,59,199,0.7
female,group B,some college,standard,0,50,51,54,155,0.5
male,group C,bachelor's degree,standard,10,95,86,88,269,0.9
male,group D,associate's degree,standard,0,65,67,60,192,0.6
female,group D,some high school,standard,10,86,94,96,276,0.9
male,group A,associate's degree,free/reduced,10,62,54,55,171,0.6
male,group E,associate's degree,standard,0,96,90,89,275,0.9
female,group C,associate's degree,standard,0,80,87,83,250,0.8
male,group C,some high school,standard,0,62,64,58,184,0.6
female,group D,some college,standard,0,70,72,81,223,0.7
male,group B,some college,free/reduced,0,66,72,67,205,0.7
male,group C,associate's degree,standard,0,87,92,81,260,0.9
male,group B,high school,free/reduced,0,49,40,42,131,0.4
male,group C,some college,standard,10,49,45,52,146,0.5
male,group B,high school,standard,10,76,81,74,231,0.8
male,group C,high school,free/reduced,0,68,65,66,199,0.7
female,group A,high school,free/reduced,10,58,73,77,208,0.7
male,group B,some college,standard,0,82,69,65,216,0.7
female,group C,high school,standard,0,62,69,64,195,0.7
female,group D,high school,standard,0,74,79,79,232,0.8
female,group D,associate's degree,standard,10,83,86,90,259,0.9
male,group D,high school,free/reduced,0,64,58,55,177,0.6
male,group E,associate's degree,standard,10,80,68,70,218,0.7
female,group B,associate's degree,standard,0,73,78,80,231,0.8
female,group C,bachelor's degree,standard,10,93,100,100,293,1.0
male,group C,associate's degree,standard,0,62,59,53,174,0.6
male,group B,associate's degree,standard,0,62,45,51,158,0.5
female,group D,high school,free/reduced,0,69,76,71,216,0.7
male,group E,bachelor's degree,standard,0,75,72,72,219,0.7
male,group D,bachelor's degree,free/reduced,0,68,68,66,202,0.7
female,group E,some high school,standard,0,89,90,86,265,0.9
male,group A,some high school,free/reduced,0,56,46,45,147,0.5
male,group B,associate's degree,free/reduced,0,65,66,59,190,0.6
male,group D,associate's degree,free/reduced,0,68,66,70,204,0.7
female,group C,high school,free/reduced,10,44,48,50,142,0.5
male,group E,associate's degree,standard,0,98,88,82,268,0.9
female,group D,bachelor's degree,standard,0,76,89,86,251,0.8
female,group D,some college,standard,0,66,67,73,206,0.7
female,group B,high school,standard,10,66,87,82,235,0.8
female,group A,some college,free/reduced,0,53,65,65,183,0.6
female,group D,associate's degree,free/reduced,0,36,62,61,159,0.5
male,group C,some college,standard,0,94,80,82,256,0.9
female,group D,high school,standard,0,39,49,50,138,0.5
male,group D,some high school,free/reduced,0,48,52,49,149,0.5
female,group B,some high school,free/reduced,0,54,74,66,194,0.6
male,group D,high school,standard,0,67,70,69,206,0.7
male,group B,high school,standard,0,89,81,82,252,0.8
female,group C,high school,standard,0,41,52,50,143,0.5
female,group C,bachelor's degree,standard,10,52,71,71,194,0.6
male,group C,some college,standard,0,90,77,77,244,0.8
male,group B,associate's degree,standard,1,73,63,64,200,0.7
female,group E,master's degree,standard,0,98,100,100,298,1.0
female,group D,associate's degree,free/reduced,1,48,58,60,166,0.6
female,group C,bachelor's degree,standard,1,58,66,70,194,0.6
female,group E,high school,free/reduced,0,61,75,69,205,0.7
female,group C,bachelor's degree,standard,1,67,63,68,198,0.7
male,group A,associate's degree,standard,0,72,62,59,193,0.6
male,group D,associate's degree,standard,1,58,70,73,201,0.7
male,group A,some high school,free/reduced,0,51,55,55,161,0.5
female,group A,high school,free/reduced,1,54,72,64,190,0.6
female,group D,some college,standard,0,72,77,81,230,0.8
female,group E,some high school,standard,0,100,94,94,288,1.0
female,group A,high school,free/reduced,1,70,73,75,218,0.7
female,group B,high school,standard,0,37,46,45,128,0.4
female,group B,some college,standard,0,63,68,64,195,0.7
male,group C,some college,free/reduced,1,70,69,63,202,0.7
male,group C,some college,standard,1,86,92,87,265,0.9
female,group C,some high school,standard,0,60,77,73,210,0.7
female,group D,bachelor's degree,free/reduced,10,68,75,82,225,0.8
male,group D,some college,standard,10,56,47,51,154,0.5
male,group C,associate's degree,standard,0,97,89,78,264,0.9
female,group C,associate's degree,standard,10,77,74,82,233,0.8
female,group D,some college,standard,0,52,62,62,176,0.6
female,group C,high school,standard,0,64,68,60,192,0.6
female,group C,some college,standard,10,72,95,90,257,0.9
male,group C,some college,free/reduced,10,57,58,58,173,0.6
female,group E,some high school,standard,0,75,73,72,220,0.7
female,group D,some high school,standard,0,64,69,65,198,0.7
female,group E,associate's degree,free/reduced,10,73,83,88,244,0.8
female,group B,high school,standard,0,47,53,56,156,0.5
male,group A,associate's degree,standard,10,73,71,72,216,0.7
male,group A,some college,standard,10,66,54,63,183,0.6
female,group E,high school,free/reduced,0,68,78,74,220,0.7
female,group D,some high school,free/reduced,0,34,39,43,116,0.4
male,group B,bachelor's degree,free/reduced,10,46,41,46,133,0.4
male,group C,high school,standard,0,57,51,52,160,0.5
male,group E,high school,standard,0,87,76,69,232,0.8
male,group B,associate's degree,free/reduced,0,51,55,49,155,0.5
female,group B,high school,standard,0,60,78,76,214,0.7
female,group D,some high school,free/reduced,10,40,57,65,162,0.5
male,group C,some high school,standard,10,70,65,62,197,0.7
male,group D,some high school,standard,0,56,54,57,167,0.6
female,group B,some high school,free/reduced,10,56,74,66,196,0.7
male,group D,high school,free/reduced,0,39,35,34,108,0.4
male,group C,high school,free/reduced,0,65,55,51,171,0.6
male,group C,master's degree,free/reduced,10,78,81,84,243,0.8
female,group C,some high school,standard,0,25,40,32,97,0.3
female,group C,master's degree,standard,10,77,90,93,260,0.9
female,group B,some college,standard,10,52,62,60,174,0.6
male,group A,bachelor's degree,standard,10,72,84,82,238,0.8
female,group C,high school,free/reduced,0,50,71,62,183,0.6
female,group E,associate's degree,standard,0,63,70,62,195,0.7
male,group C,high school,standard,0,73,74,70,217,0.7
male,group D,high school,standard,0,63,60,60,183,0.6
male,group D,master's degree,free/reduced,0,49,54,52,155,0.5
male,group C,high school,standard,0,74,70,59,203,0.7
female,group D,some college,free/reduced,0,66,81,73,220,0.7
female,group D,some high school,standard,10,69,67,80,216,0.7
male,group C,associate's degree,standard,0,46,46,41,133,0.4
female,group B,some college,free/reduced,0,47,62,59,168,0.6
male,group D,master's degree,standard,0,62,54,56,172,0.6
male,group E,high school,standard,0,80,66,70,216,0.7
male,group B,master's degree,standard,0,73,74,74,221,0.7
female,group D,high school,free/reduced,10,66,77,82,225,0.8
female,group B,associate's degree,free/reduced,0,49,65,58,172,0.6
male,group C,bachelor's degree,standard,10,96,95,95,286,1.0
male,group D,some high school,free/reduced,0,54,52,48,154,0.5
female,group A,associate's degree,standard,10,65,73,73,211,0.7
male,group C,bachelor's degree,standard,0,65,62,60,187,0.6
female,group C,high school,free/reduced,0,61,68,61,190,0.6
male,group D,some high school,standard,10,64,65,60,189,0.6
female,group E,associate's degree,free/reduced,10,50,66,59,175,0.6
male,group E,bachelor's degree,standard,0,62,56,55,173,0.6
male,group D,some college,standard,0,78,64,60,202,0.7
male,group D,bachelor's degree,standard,0,56,60,60,176,0.6
male,group C,high school,standard,0,62,69,62,193,0.6
male,group C,high school,free/reduced,0,49,47,43,139,0.5
female,group B,high school,standard,0,70,71,72,213,0.7
male,group A,high school,standard,0,64,71,64,199,0.7
female,group C,high school,standard,0,76,80,82,238,0.8
male,group C,some high school,standard,0,47,43,42,132,0.4
male,group C,some high school,standard,0,42,36,32,110,0.4
female,group D,some college,standard,0,56,53,58,167,0.6
male,group D,bachelor's degree,standard,0,65,66,64,195,0.7
male,group C,associate's degree,standard,0,89,86,80,255,0.9
male,group E,some high school,standard,10,90,82,78,250,0.8
male,group E,associate's degree,standard,10,89,77,87,253,0.8
female,group C,some high school,standard,10,80,85,87,252,0.8
